W W W W W W W W W W W W W W W W W W W W 
W W W W W W W W W W W W W W W W W W W W 
W W X X X X X V V W V W O W V V V V V W 
W W X W W W X W W W V W O W W W W W V W 
W W X W V V X W O V X X E O O W V W V W 
W W X W W W X W W W X W O W W W V W V W 
W W X W V V X X X X X W O W V V V V V W 
W W X W W W V W V W V W W W V W W W W W 
W W X V V W V W V W V W V V V W V W V W 
W W X W W W W W W W W W W W V W V W V W 
W W X X X V V W V W V W V V V V V V V W 
W W V W X W W W V W V W W W V W W W V W 
W W V W X V V W V V V V V V V W V W V W 
W W W W X W W W W W W W W W W W V W V W 
W W V V X V V W V W V W V W V V V V V W 
W W W W X W W W V W V W V W W W V W W W 
W W V V X V V W X X X X X V V W V V V W 
W W W W X W W W X W W W X W W W V W W W 
W W V V X X X X X V V W X X X X X B V W 
W W W W W W W W W W W W W W W W W W W W 
